#####################################################
#---------------------------------------------------#
#--------------------------------------------c------#
#----S----------------------------------------------#
#---------------------------------------------------#
#---------------------------------G-----------------#
#---------------------------------------------------#
#---------------------------------------------------#
#---------------------@-----------------------------#
#---------------------------------------------------#
#-----c---------------------------------------------#
#---------------------------------------------------#
#---------------------------------------------------#
#---------------------------------------------------#
#-------------------------------F-------------------#
#---------------------------------------------------#
#--------------------------------------------c------#
#---------------------------------------------------#
#####################################################