#####################################################
#---------------------------------------------------#
#---------------------------------------------------#
#----S----------------------------------------------#
#---------------------------------------------------#
#---------------------------------G-----------------#
#---------------------------------------------------#
#---------------------------------------------------#
#---------------------@-----------------------------#
#---------------------------------------------------#
#---------------------------------------------------#
#---------------------------------------------------#
#---------------------------------------------------#
#---------------------------------------------------#
#-------------------------------F-------------------#
#---------------------------------------------------#
#---------------------------------------------------#
#---------------------------------------------------#
#####################################################