#############################################
#-------------------------------------------#
#------------------------------------c------#
#----S--------------G-----------------------#
#-------------------------------------------#
#---------------------------------G---------#
#-------------------------------------------#
#-------------------------------------------#
#-------------------F-@---------------------#
#-------------------------------------------#
#-----c-------------------------------------#
#-------------------------------------------#
#-------------------------------------------#
#-------------------------------------------#
#-------------------------------F-----------#
#------S------------------------------------#
#------------------c-----------------c------#
#-------------------------------------------#
#############################################